###########
#         #
#1#0#1#0#1#
#110101011#
#1#1#1#1#1#
#110101011#
#1#0#1#0#1#
#         #
###########
