###########
#  10001  #
# # #1# # #
#1 01010 1#
#0#1#1#1#0#
#1 01010 1#
# # #1# # #
#  10001  #
###########
