###############
#  111000111  #
# #1#1#0#1#1# #
#0 111000111 0#
#0#1#1#0#1#1#0#
#1           1#
#0#0#0#0#0#0#0#
#1           1#
#0#1#1#0#1#1#0#
#0 111000111 0#
# #1#1#0#1#1# #
#  111000111  #
###############
