###################
#  1001001001001  #
# #1#0#1#1#1#0#1# #
#11 0111  1110  11#
# #0#0#1#0#1#0#0# #
#0111100   0011110#
#0#1#1#1#0#1#1#1#0#
#0110 001 100 0110#
#1#1#1#0#1#0#1#1#1#
#0110 001 100 0110#
#0#1#1#1#0#1#1#1#0#
#0111100   0011110#
# #0#0#1#0#1#0#0# #
# 11 0111  1110 11#
# #1#0#1#1#1#0#1# #
#  1001001001001  #
###################
