###################
#  1 0 0 1 0 0 1  #
#  01 0 010 0 10  #
# 0 01 0 1 0 10 0 #
#0 0 01 010 10 0 0#
# 0 0 01 # 10 0 0 #
#0 1 0  ###  0 1 0#
# 0 0  #####  0 0 #
#11111#     #11111#
#    ###   ###    #
# 1 ##### ##### 1 #
#  1 0 0 1 0 0 1  #
# 1 0 0 010 0 0 1 #
#1 0 0 0 1 0 0 0 1#
# 0 0 0 010 0 0 0 #
#  0 0 0 1 0 0 0 0#
###################
