###################
#  100  0 0    1  #
# # # # # #0#0#0# #
#0 111   001  0  1#
# # # #0#0# #0#1# #
#000 0  00  00111 #
#0#0#1#0# # # #1# #
# 1   1  00   00 1#
#1# #1# # #1# # #1#
#   0 0010 110   0#
# #0#0#0#0#1#0#1# #
#101 000   00  100#
#1#1#1#1#1# #1# #0#
# 1  0       1  00#
# # #1#1#0#0# # # #
#   0 00000   01  #
###################
