###############
#  00011  01  #
# # # # # # # #
#0 101   0 1 0#
# # #1#0# # # #
# 00   010 000#
# # # # # # # #
#10 10 0 0  0 #
# #0#1#0#0# # #
#    100  1 01#
# #1#0# # # # #
#  0 1   01   #
###############
